111111111111111111111111111111111
1E0000000000001111111111111111111
1000X0000C00001111111111111111111
100000000000001111111111111111111
100010000000001111111111111111111
1000E000C000001111111111111111111
10C0000000P0001111111111111111111
110000001000001111111111111111111
111111111111111111111111111111111
110000001000001111111111111111111
101010101010101111111111111111111
111111111111111111111111111111111
111111111111111111111111111111111
111111111111111111111111111111111
111111111111111111111111111111111
111111111111111111111111111111111
