111111111111111
1E0000000000001
1000X0000C00001
100000001000001
100010001000001
1000E000C000001
10C0000000P0001
110000001000001
111111111111111
110000001000001
101010101010101
111111111111111
111111111111111
111111111111111
111111111111111
111111111111111
