111111111111111
1E0000000000001
100000000000001
100000X00000001
100000000000001
100000000000001
10C0000000P0001
110000000000001
111111111111111
