111111111111111
1E0000000000001
1000X00010C0001
100000001000001
100000001000001
1000E000C000001
10C0000000P0001
110000000000001
111111111111111
