111111111111111
1E0000000000001
100000010000001
10000C000000001
100000001000001
10000C000000001
10C0000000P0001
110001100000001
111111111111111
