111111111111111
1E0000000000001
10C0000000P0001
10C0000000P0001
10C0000000P0001
10C0000000P0001
10C0000000P0001
10C0000000P0001
111111111111111
