111111111111111
1E000P000000001
10C0000000P0001
10C0000000P0001
10C0000000P0001
10C0000000P0001
10C0000000P0001
10C0000000P0001
111111111111111
