11111111
1E000001
1000X001
10000001
10001001
1000E001
10C00P01
11000001
11111111
11111111
11111111
11111111
11111111
11111111
11111111
11111111
