111111111111111
1E00000000000011
1000010000000001
1000000000000011
100000000000001
100000000000001
10C0000000P0001
110000000000001
111111111111111
